Year,Quarter,1. Sales,2. Sales deductions,3. Net sales,4. Cost of sales,5. Gross Profit,6. Financial income,7. of which: interest expenses,Interest expenses,8.Selling expenses,9. General and admin expenses,10 Operating profit/(loss),11. Other incomes,12. Other expenses,13. Net other income/(expenses),13b. Venture company profit/(loss),14. Net accounting profit/(loss) before tax,15. Business income tax - current,16. Business income tax - deferred,17. Business income tax expenses,18. Net profit/(loss) after tax,19. Minority Interests,20. Attributable to parent company,21. EPS Basis,22. EPS Diluted
2007,0,0,0,0,0,0,393754417,0,0,0,-287918912,105835505,0,0,0,0,105835505,-29633941,0,-29633941,76201564,0,76201564,0,0
2008,0,594750000,0,594750000,-310962987,283787013,2503132321,0,0,-4195455,-2914466728,-131742849,33139484,-2947570,30191914,0,-101550935,0,0,0,-101550935,0,-101550935,0,0
2009,0,88589599858,0,88589599858,-84315400879,4274198979,1187923953,-3345792696,-3345403508,-2989873392,-7905645651,-8779188807,5961852789,-2984590389,2977262400,0,-5801926407,-91717115,0,-91717115,-5893643522,0,-5893643522,-263,0
2010,0,86595329551,0,86595329551,-70030566690,16564762861,1765935416,-28186400984,-27699337507,-1347745902,-7253927716,-18457376325,27629918282,-693015977,26936902305,0,8479525980,-374881778,0,-374881778,8104644202,0,8104644202,360,0
2011,0,183527029659,0,183527029659,-146941504721,36585524938,2548277256,-52860304451,-52401925888,-1373089314,-8775807355,-23875398926,611420796,81706702,693127498,0,-23182271428,-327853296,0,-327853296,-23510124724,0,-23510124724,-1007,0
2012,0,133821264269,0,133821264269,-95277742447,38543521822,8016772922,-36090547535,-33587057708,-1334809193,-8288632595,846305421,671212074,-430025993,241186081,0,1087491502,0,0,0,1087491502,0,1087491502,33,0
2013,0,187476967373,0,187476967373,-142035487874,45441479499,2116039851,-21487568763,-20058304006,-1778480137,-13557460173,10734010277,748594971,-336200053,412394918,0,11146405195,0,0,0,11146405195,0,11146405195,337,0
2014,0,282559405742,0,282559405742,-216441779106,66117626636,5723762665,-16517585330,-14560645767,-8435895404,-20894709986,25993198581,1077467975,-1026067780,51400195,0,26044598776,0,0,0,26044598776,0,26044598776,662,0
2015,0,276246149007,0,276246149007,-192089402037,84156746970,3638289667,-20972025873,-14762297542,-7619019256,-21315618434,37888373074,252549134,-2822499973,-2569950839,0,35318422235,-1524863742,0,-1524863742,33793558493,0,33793558493,718,0
2016,0,155001968640,0,155001968640,-105141310983,49860657657,1956365363,-21117285683,-13993728791,-5456461325,-24980137554,263138458,5023527994,-523543851,4499984143,0,4763122601,-262823019,0,-262823019,4500299582,0,4500299582,96,0
2017,0,192062339469,0,192062339469,-126589447425,65472892044,371796836,-11562853703,-10558652893,-7802800955,-24736725415,21742308807,511547931,-3363695450,-2852147519,0,18890161288,-661403781,0,-661403781,18228757507,0,18228757507,387,0
2018,0,266675459518,0,266675459518,-167755500854,98919958664,873384542,-11536008137,-11127435194,-29243740744,-31988956686,27024637639,69202432,-1391354241,-1322151809,0,25702485830,-1140526011,0,-1140526011,24561959819,0,24561959819,522,0
2019,0,322095594412,0,322095594412,-218008949004,104086645408,1386794451,-3190642945,-5593210304,-39344463746,-31887443159,31050890009,61486595,-923146672,-861660077,0,30189229932,-1712287575,0,-1712287575,28476942357,0,28476942357,605,0
